******
**XXX*
***X**
X*XXXX
******